,Date,O+,O-,A+,A-,B+,B-,AB+,AB-,HH
0,1,43,52,37,40,15,6,10,3,7
1,2,18,70,47,41,39,49,46,83,8
2,3,55,20,78,58,92,21,46,59,8
3,4,28,28,3,88,4,95,6,79,3
4,5,44,23,46,18,38,72,56,14,0
5,6,53,8,22,22,79,95,99,18,3
6,7,27,22,17,95,1,13,5,78,2
7,8,81,83,75,31,14,63,31,95,0
8,9,25,15,77,98,73,77,98,30,6
9,10,93,14,99,10,51,41,21,73,1
